NO ./assets/textures/north.xpm
SO ./assets/textures/south.xpm
WE ./assets/textures/west.xpm
EA ./assets/textures/east.jpg

F 60,60,60
C 135,206,235

1111111111
1000000001
1000000001
10000N 001
1111111111
