
NO ./assets/textures/north.xpm
SO ./assets/textures/south.xpm
WE ./assets/textures/west.xpm
EA ./assets/textures/east.xpm

111111
100001
1 00N1
110001
111111

F 60,60,60
C 135,206,235
