NO ./assets/textures/north.xpm
SO ./assets/textures/south.xpm
WE ./assets/textures/west.xpm
EA ./assets/textures/east.xpm
F 60,60,60
C 135,206,235

111111
102001
10N001
100001
111111
