NO ./textures/wall_north.xpm
SO ./textures/wall_south.xpm
WE ./textures/wall_west.xpm
EA ./textures/wall_east.xpm
F 0,0,0
C 255,255,255

1111111111111111
1000000000000001
1000000000000001
1000001000000001
1000000000000001
100000N0000000101
1000000000000001
1000000000000001
1111111111111111
