R 1920 1080
NO ./textures/colorstone.xpm
SO ./textures/bluestone.xpm
WE ./textures/greystone.xpm
EA ./textures/wood.xpm

S ./textures/barrel.xpm
F 255,248,220
C 135,206,250

1111111111111111111111111
1000000000110000000000001
1011000001110000001000001
1001000000000000000000001
1111111110110000011100001
1000000000110000011101111
1111011111111101110000001
1111011111111101110101001
1100100011010101110000001
1001 1000000000110000001
1000100000P00000110101001
1100000111010101111101101
1111011111110101110111101
1111111111111111111111111
