NO ./textures/wall_north.xpm
SO ./textures/wall_south.xpm
WE ./textures/wall_west.xpm
EA ./textures/wall_east.xpm
F 60,60,60
C 135,206,235

11111111111
10000000001
1000S000001
10000000001
11111100111
     1001
     1001
     1111
