NO ./textures/wall_north.xpm
SO ./textures/wall_south.xpm
WE ./textures/wall_west.xpm
EA ./textures/wall_east.xpm

F 72,72,72
C 32,32,32

   111111111111111111
111   111           11   
1N      1 11   1111  11   
111       1	          1
1111111111 111111111111
