NO ./textures/wall_north.xpm
SO ./textures/wall_south.xpm
WE ./textures/wall_west.xpm
EA ./textures/wall_east.xpm
F 72,72,72
C 32,32,32

   111111111   
  11111110011
11111111111111111
1000000000    11
11  11         111
1                1
111111111111101111
111111111000000001
     1000001000001
     10000E01010001
     1000000000001
     1111111111111
