NO ./assets/textures/north.xpm
SO ./assets/textures/south.xpm
WE ./assets/textures/west.xpm
EA ./assets/textures/east.xpm
F 60,60,60
C 135,206,235

11111111111
10000000001
1000N000001
10000000001
11111111111
     1111
     1001
     1111
